11111111111
1E0P0000001
100C0000001
10000000001
11111111111