11111111111111
100000000000P1
10000000000001
10011111111111
1000C0000000E1
11111111111111
