11111111111111
1000000P000001
1C0E0000000001
11111111111111