11111111111
1C1P00001E1
10100000111
10000000001
11111111111