11111111111
1C1P10001C1
101100001E1
10000000001
11111111111