11111111111111111111111111111
100P0000011100000000000000001
1010000000E100000000000000001
10000111111111111111111111101
11110000C00000000000C00000001
10C000000000C0000000C00000001
11111111111111111111111111111