11111111111111111111111111111
100P0000000000000000000000001
1000000000E000000000000000001
10000111111111111111111111101
10000000000000000000000000001
10C00000000000000000000000001
11111111111111111111111111111