11111111111111111111111111111
101P0000011100000000000000001
10E10C00010100000000000000001
10000111111111111111111111101
11110000000000000000000000001
10010000000000000000000000001
11111111111111111111111111111