11111111111111
1P00000E000001
10011111111111
10000C00000001
11111111111111






kkkk
